map1 layout
Types: R=Road, #=Ground, O=Obstacle

R#####RR#R
R#O#RRRRR#
####R#####
####R#####
###RR#####
RRRR######
R#######R#
##########
##########
#####RO###